26 6
##########################
##.#######....########..##
#.........#.............##
#.#..###....#.........#.##
#.............#.#.....#x##
##########################
