100 100
####################################################################################################
#...........................................................###....................................#
#...........................................................###....................................#
#...........................................................###....................................#
#...........................................................###....................................#
#...........................................................###....................................#
#...........................................................###....................................#
#...........................................................###....................................#
#...........................................................###....................................#
#...........................................................###....................................#
#...........................................................###....................................#
#...........................................................###....................................#
#...........................................................###....................................#
#...........................................................###....................................#
#...........................................................###....................................#
#...........................................................###....................................#
#...........................................................###....................................#
#...........................................................###....................................#
#...........................................................###....................................#
#...........................................................###....................................#
#...........................................................###....................................#
#...........................................................###....................................#
#...........................................................###....................................#
#...........................................................###....................................#
#...........................................................###....................................#
#...........................................................###....................................#
#...........................................................###....................................#
#...........................................................###....................................#
#...........................................................###....................................#
#...........................................................###....................................#
#...........................................................###....................................#
#...........................................................###....................................#
#...........................................................###....................................#
#...........................................................###....................................#
#...........................................................###....................................#
#...........................................................###....................................#
#...........................................................###....................................#
#...........................................................###....................................#
#...........................................................###....................................#
#...........................................................###....................................#
#...........................................................###....................................#
#...........................................................###....................................#
#...........................................................###....................................#
#...........................................................###....................................#
#...........................................................###....................................#
#...........................................................###....................................#
#...........................................................###....................................#
#...........................................................###....................................#
#...........................................................###....................................#
#...........................................................###....................................#
#...........................................................###....................................#
#...........................................................###....................................#
#...........................................................###....................................#
#...........................................................###....................................#
#...........................................................###....................................#
#...........................................................###....................................#
#...........................................................###....................................#
#...........................................................###....................................#
#...........................................................###....................................#
#...........................................................###....................................#
#...........................................................###....................................#
#...........................................................###....................................#
#...........................................................###....................................#
#...........................................................###....................................#
#...........................................................###....................................#
#...........................................................###....................................#
#...........................................................###....................................#
#...........................................................###....................................#
#...........................................................###....................................#
#...........................................................###....................................#
#...........................................................###....................................#
#...........................................................###....................................#
#...........................................................###....................................#
#...........................................................###....................................#
#...........................................................###....................................#
#...........................................................###....................................#
#...........................................................###....................................#
#...........................................................###....................................#
###############################################.............###....................................#
###############################################.............###....................................#
###############################################.............###....................................#
###############################################.............###....................................#
###############################################.............###....................................#
###############################################.............###....................................#
###############################################.............###....................................#
###############################################.............###....................................#
###############################################.............###....................................#
###############################################.............###....................................#
###############################################.............###....................................#
###############################################.............###....................................#
###############################################.............###....................................#
#...........................................................###....................................#
#..................................................................................................#
#.......#####################################################################......................#
#.......#####################################################################......................#
#.......#####################################################################......................#
#..................................................................................................#
#..................................................................................................#
#................................................................................................x.#
####################################################################################################
